NO ./assets/22.xpm
SO ./assets/2.xpm
WE ./assets/3.xpm
EA ./assets/33.xpm

F 0,0,0
C 190,130,0

        111111111111111111111111111
        101100000111000000000000111
        100100000000000000000000111
11111111101100000111000000000000111
100000000011000001110111111111111
111101111111110111000000100010W1
1111011111111101110101010001011
11000000110101011100000010001
10000000000000001100000010001
10000000000000001101010010001
1100000111010101111101111000111
11110111 1100101 101111010001
11111111 1111111 111111111111
